1,10796,0,7924,2872,751003,839962
2,10994,0,5221,5773,1060092,1569056
3,10761,0,3470,7291,1142544,2152237
4,10837,0,3120,7717,1225363,2493706
5,10647,0,2907,7740,1228074,2529913
6,10804,0,2954,7850,1274636,2537047
7,10742,0,2896,7846,1300629,2532689
8,10878,0,3034,7844,1355964,2534067
9,10835,0,2909,7926,1362256,2531577
10,10780,0,2913,7867,1374410,2528231
11,10690,0,2863,7827,1383125,2533804
12,10716,0,3021,7695,1470468,2530056
13,10896,0,2842,8054,1513358,2536497
14,10780,0,2918,7862,1487450,2530597
15,10819,0,3025,7794,1501129,2528117
16,10805,0,2979,7826,1534174,2533867
17,10945,0,2898,8047,1555817,2532342
18,10757,0,2942,7815,1550363,2530369
19,10824,0,2954,7870,1555810,2535336
20,10954,0,2976,7978,1584786,2528944
21,10893,0,3013,7880,1600212,2529622
22,10903,0,2921,7982,1596622,2536104
23,10882,0,3018,7864,1642371,2533998
24,10847,0,3035,7812,1611396,2532865
25,10681,0,2956,7725,1609814,2532761
26,10728,0,3051,7677,1661790,2533050
27,10887,0,3012,7875,1669516,2533746
28,10920,0,3059,7861,1685151,2533608
29,10757,0,3088,7669,1701097,2536010
30,10799,0,3035,7764,1692847,2530674
31,10676,0,3053,7623,1707558,2535192
32,10869,0,2985,7884,1744610,2535894
33,10773,0,2911,7862,1732403,2536018
34,10983,0,3077,7906,1769743,2536285
35,11004,0,3031,7973,1798232,2535126
36,10947,0,2973,7974,1789658,2528309
37,10716,0,2997,7719,1755865,2534171
38,10811,0,3067,7744,1762711,2535136
39,10891,0,3014,7877,1814933,2532988
40,10898,0,3085,7813,1837587,2534763
41,10905,0,3046,7859,1815525,2538850
42,10745,0,3011,7734,1841282,2533208
43,10920,0,3120,7800,1846684,2538926
44,10847,0,3044,7803,1837553,2533885
45,10921,0,3180,7741,1869687,2537148
46,10741,0,3053,7688,1902383,2531725
47,10713,0,3020,7693,1880498,2534998
48,10780,0,2986,7794,1914690,2531966
49,10798,0,3025,7773,1934743,2531323
50,10931,0,3111,7820,1934906,2532750
51,10868,0,3096,7772,1943292,2531926
52,10983,0,3067,7916,1963981,2530231
53,10819,0,3022,7797,1973361,2530701
54,10877,0,2999,7878,1956914,2536433
55,11071,0,3081,7990,2030284,2532878
56,10935,0,3072,7863,2000840,2534923
57,10962,0,3102,7860,2003650,2533735
58,10701,0,3006,7695,2001124,2534838
59,10822,0,3087,7735,2009378,2530852
60,10797,0,2993,7804,2026297,2532582
61,9824,0,2925,6899,1990789,2535800
62,9909,0,2648,7261,1945823,2534732
63,9807,0,2662,7145,1929147,2537281
64,9795,0,2528,7267,1928841,2534710
65,10142,0,2599,7543,1948476,2532481
66,9695,0,2469,7226,1924048,2537707
67,9775,0,2578,7197,1924017,2528155
68,10037,0,2501,7536,1944512,2530848
69,9851,0,2588,7263,1939445,2530050
70,9987,0,2586,7401,1929116,2533107
71,9876,0,2463,7413,1927765,2531332
72,9991,0,2533,7458,1962528,2532373
73,9769,0,2420,7349,1946230,2530188
74,9770,0,2503,7267,1925611,2532715
75,9846,0,2523,7323,1945113,2534714
76,9762,0,2526,7236,1937296,2533500
77,9802,0,2536,7266,1924385,2530939
78,9895,0,2507,7388,1930185,2534690
79,9807,0,2456,7351,1967854,2522738
80,9930,0,2572,7358,1968693,2535485
81,10200,0,2585,7615,2002639,2531373
82,9949,0,2467,7482,1999688,2535733
83,9822,0,2460,7362,1999503,2535931
84,9837,0,2492,7345,1994642,2532730
85,9958,0,2560,7398,1981554,2531717
86,9885,0,2507,7378,2003975,2529507
87,9681,0,2461,7220,1979959,2527027
88,9930,0,2511,7419,1991856,2532403
89,9832,0,2577,7255,2006368,2533774
90,9951,0,2566,7385,2007650,2531391
91,9836,0,2610,7226,2000151,2530343
92,9929,0,2558,7371,2013339,2534774
93,9897,0,2528,7369,2026011,2537072
94,9709,0,2540,7169,2010694,2532539
95,9957,0,2555,7402,2038604,2533946
96,9861,0,2525,7336,2048519,2534683
97,9713,0,2503,7210,2023125,2532216
98,9770,0,2573,7197,2026450,2534606
99,9773,0,2449,7324,2033717,2532885
100,9821,0,2510,7311,2045092,2529700
101,9960,0,2624,7336,2062814,2529590
102,9999,0,2597,7402,2076639,2531535
103,9941,0,2510,7431,2052742,2533470
104,9813,0,2599,7214,2042075,2534027
105,9818,0,2506,7312,2084298,2531801
106,9873,0,2608,7265,2064693,2536955
107,10062,0,2594,7468,2111891,2532392
108,9860,0,2539,7321,2081424,2527570
109,9838,0,2507,7331,2085999,2529670
110,9815,0,2528,7287,2081700,2528113
111,9905,0,2508,7397,2095810,2535715
112,9942,0,2569,7373,2128838,2532258
113,9972,0,2605,7367,2098234,2535988
114,9866,0,2523,7343,2095747,2534469
115,9914,0,2529,7385,2098548,2532364
116,9809,0,2460,7349,2094027,2531486
117,9841,0,2515,7326,2083077,2533999
118,9853,0,2602,7251,2124719,2533442
119,9864,0,2646,7218,2106494,2531240
120,9941,0,2665,7276,2108619,2533900
121,9452,0,2483,6969,2085330,2534309
122,9426,0,2388,7038,2092214,2531865
123,9460,0,2443,7017,2102408,2530385
124,9515,0,2317,7198,2126504,2534823
125,9454,0,2363,7091,2109158,2533572
126,9376,0,2196,7180,2095836,2533335
127,9415,0,2316,7099,2093863,2532358
128,9609,0,2376,7233,2100508,2535690
129,9575,0,2395,7180,2118534,2532616
130,9348,0,2241,7107,2097376,2530371
131,9356,0,2249,7107,2087265,2535959
132,9450,0,2255,7195,2122442,2528494
133,9421,0,2147,7274,2096504,2529609
134,9480,0,2323,7157,2102952,2528938
135,9372,0,2271,7101,2082889,2533775
136,9532,0,2283,7249,2101542,2532516
137,9641,0,2392,7249,2123517,2531887
138,9409,0,2264,7145,2118664,2525821
139,9667,0,2351,7316,2127651,2527563
140,9387,0,2270,7117,2114335,2534623
141,9435,0,2215,7220,2103141,2536123
142,9492,0,2341,7151,2116656,2530837
143,9529,0,2327,7202,2099566,2534055
144,9642,0,2298,7344,2132804,2531605
145,9363,0,2303,7060,2113873,2531591
146,9511,0,2210,7301,2124507,2528659
147,9617,0,2361,7256,2138117,2534870
148,9441,0,2203,7238,2122330,2532254
149,9589,0,2280,7309,2123143,2533109
150,9517,0,2282,7235,2134271,2532774
151,9498,0,2247,7251,2130382,2534351
152,9596,0,2334,7262,2116738,2526778
153,9565,0,2296,7269,2146478,2530043
154,9477,0,2380,7097,2135956,2536694
155,9494,0,2317,7177,2134177,2531506
156,9566,0,2307,7259,2125533,2530060
157,9422,0,2316,7106,2124609,2533071
158,9473,0,2235,7238,2142844,2529493
159,9549,0,2303,7246,2113470,2536825
160,9505,0,2352,7153,2090766,2532692
161,9421,0,2286,7135,2080632,2535772
162,9645,0,2392,7253,2076706,2535370
163,9485,0,2302,7183,2098361,2534913
164,9414,0,2313,7101,2092985,2534280
165,9494,0,2289,7205,2113629,2531763
166,9480,0,2321,7159,2084725,2534679
167,9515,0,2318,7197,2097040,2530100
168,9451,0,2311,7140,2095961,2534715
169,9558,0,2332,7226,2125215,2529276
170,9536,0,2327,7209,2119349,2528214
171,9317,0,2326,6991,2074905,2532349
172,9557,0,2338,7219,2077612,2531092
173,9200,0,2271,6929,2082642,2534121
174,9390,0,2308,7082,2076394,2528699
175,9474,0,2305,7169,2089832,2532468
176,9420,0,2320,7100,2087956,2534921
177,9442,0,2300,7142,2093201,2526507
178,9424,0,2310,7114,2080787,2532680
179,9549,0,2345,7204,2070681,2533307
180,9581,0,2407,7174,2045017,2532651
181,9804,0,2426,7378,2060087,2529958
182,9676,0,2340,7336,2017136,2536785
183,9764,0,2319,7445,2035846,2529237
184,9782,0,2309,7473,2043492,2533576
185,9950,0,2357,7593,2045995,2532430
186,9753,0,2348,7405,2041274,2535207
187,9651,0,2237,7414,2032592,2529255
188,9754,0,2287,7467,2028811,2533641
189,9648,0,2210,7438,2022738,2530682
190,9798,0,2359,7439,2001675,2531560
191,9835,0,2350,7485,2015647,2527345
192,9702,0,2248,7454,2001183,2529888
193,9716,0,2279,7437,1999461,2531378
194,9731,0,2332,7399,2015688,2531858
195,9820,0,2307,7513,2020501,2528260
196,9572,0,2249,7323,1993739,2532632
197,9859,0,2228,7631,2007506,2529879
198,9717,0,2389,7328,1996311,2530736
199,9750,0,2288,7462,1996466,2537712
200,9814,0,2325,7489,2003848,2532115
201,9604,0,2266,7338,2014091,2534502
202,9683,0,2328,7355,2008074,2531689
203,9857,0,2373,7484,2000758,2535417
204,9626,0,2216,7410,1996410,2537232
205,9819,0,2374,7445,2006803,2532981
206,9908,0,2321,7587,2021596,2535832
207,9894,0,2316,7578,2011391,2533088
208,9624,0,2279,7345,1998219,2534077
209,9683,0,2262,7421,2019400,2530478
210,9832,0,2382,7450,2025685,2535595
211,9717,0,2297,7420,2009915,2533013
212,9613,0,2293,7320,1987580,2530470
213,9569,0,2355,7214,1970728,2531449
214,9570,0,2214,7356,1961752,2535241
215,9811,0,2314,7497,1977263,2524812
216,9767,0,2319,7448,1993558,2533234
217,9730,0,2258,7472,1989150,2529456
218,9741,0,2305,7436,1986897,2534758
219,9744,0,2276,7468,1987673,2533506
220,9624,0,2308,7316,1993605,2527664
221,9737,0,2280,7457,1970823,2532075
222,9671,0,2305,7365,1975851,2528241
223,9840,0,2388,7453,1976081,2526101
224,9647,0,2260,7387,1959352,2528125
225,9682,0,2307,7375,1938113,2531082
226,9859,0,2405,7454,1947092,2535420
227,9798,0,2366,7432,1978224,2529911
228,9636,0,2272,7364,1947399,2530749
229,9774,0,2280,7494,1949584,2536756
230,9736,0,2316,7420,1958275,2531015
231,9751,0,2419,7332,1942111,2532195
232,9684,0,2314,7370,1944219,2532274
233,9754,0,2329,7425,1933246,2535404
234,9802,0,2270,7532,1946967,2534171
235,9703,0,2313,7390,1943633,2533105
236,9765,0,2316,7449,1959589,2533459
237,9812,0,2290,7522,1947962,2527897
238,9746,0,2258,7488,1957677,2532018
239,9638,0,2224,7414,1902101,2535703
240,9719,0,2398,7321,1922224,2527465
241,9380,0,2318,7062,1886607,2532255
242,9353,0,2263,7090,1905327,2530787
243,9091,0,2201,6890,1889363,2534829
244,9279,0,2209,7070,1867416,2532997
245,9252,0,2188,7064,1882966,2533348
246,9124,0,2166,6958,1873845,2531906
247,9170,0,2169,7001,1880948,2531926
248,9307,0,2256,7051,1855374,2535416
249,9043,0,2144,6899,1854743,2532385
250,9200,0,2223,6977,1842111,2526622
251,9317,0,2227,7090,1867799,2531747
252,9241,0,2169,7072,1862310,2533703
253,9278,0,2302,6976,1849461,2530824
254,9425,0,2238,7187,1839647,2529250
255,9279,0,2271,7008,1839397,2532389
256,9183,0,2204,6979,1819015,2535520
257,9164,0,2203,6961,1816784,2532558
258,9320,0,2251,7069,1825395,2532963
259,9390,0,2268,7122,1833906,2534107
260,9424,0,2256,7168,1807925,2531502
261,9386,0,2184,7202,1814362,2530046
262,9358,0,2222,7136,1824400,2534346
263,9270,0,2192,7078,1801693,2528917
264,9415,0,2248,7167,1787381,2534530
265,9392,0,2229,7163,1793031,2529504
266,9245,0,2157,7088,1783131,2527475
267,9269,0,2207,7062,1777769,2527163
268,9175,0,2201,6974,1760229,2535637
269,9242,0,2187,7055,1791893,2533580
270,9252,0,2268,6984,1775114,2532438
271,9311,0,2235,7076,1757319,2535165
272,9253,0,2283,6970,1754506,2536237
273,9272,0,2244,7028,1779976,2524016
274,9207,0,2136,7071,1744554,2535342
275,9094,0,2101,6993,1754122,2531261
276,9273,0,2206,7067,1750240,2532085
277,9271,0,2197,7074,1742568,2535862
278,9239,0,2142,7097,1748550,2529841
279,9162,0,2128,7034,1724407,2531223
280,9315,0,2293,7022,1720055,2530901
281,9097,0,2171,6926,1720745,2533153
282,9215,0,2141,7074,1712099,2531219
283,9193,0,2125,7068,1737766,2538391
284,9181,0,2092,7089,1718748,2533590
285,9198,0,2226,6972,1693881,2531377
286,9273,0,2120,7153,1702604,2532946
287,9247,0,2263,6984,1704484,2530169
288,9348,0,2258,7090,1745440,2530853
289,9374,0,2229,7145,1727318,2534642
290,9355,0,2214,7141,1710549,2534255
291,9404,0,2245,7159,1702082,2528174
292,9532,0,2318,7214,1703587,2537731
293,9263,0,2259,7004,1682994,2526679
294,9204,0,2216,6988,1697929,2526526
295,9266,0,2304,6962,1693975,2534881
296,9615,0,2345,7270,1681933,2533552
297,9211,0,2289,6922,1661521,2537424
298,9232,0,2193,7039,1661199,2536752
299,9225,0,2234,6991,1670447,2530204
300,9369,0,2222,7147,1671604,2538068
301,9600,0,2497,7103,1677012,2530783
302,9800,0,2506,7294,1692320,2536865
303,9839,0,2463,7376,1714255,2530199
304,9838,0,2471,7367,1680471,2537681
305,9863,0,2423,7440,1691166,2536143
306,9674,0,2418,7256,1699416,2533327
307,9589,0,2299,7290,1712735,2530251
308,9904,0,2480,7424,1716127,2531495
309,9783,0,2420,7363,1695150,2533997
310,9708,0,2378,7330,1715651,2532531
311,9674,0,2379,7295,1698078,2532976
312,9610,0,2410,7200,1686468,2534557
313,9916,0,2455,7461,1702422,2532549
314,9849,0,2443,7406,1706581,2527539
315,9896,0,2348,7548,1703403,2534912
316,9706,0,2396,7310,1696214,2531263
317,9646,0,2337,7309,1706527,2531471
318,9948,0,2442,7506,1746451,2532158
319,9764,0,2444,7320,1740069,2531933
320,9736,0,2414,7322,1720932,2536463
321,9871,0,2430,7441,1705534,2534995
322,9697,0,2437,7260,1720449,2528260
323,9820,0,2422,7398,1714769,2532562
324,9818,0,2418,7400,1723496,2529520
325,9639,0,2347,7292,1726005,2533652
326,9786,0,2496,7290,1703321,2537796
327,9643,0,2446,7197,1699782,2534310
328,9747,0,2418,7329,1703672,2531329
329,9610,0,2451,7159,1710835,2533282
330,9675,0,2405,7270,1713854,2531428
331,9780,0,2505,7275,1738538,2529714
332,9532,0,2310,7222,1689456,2532655
333,9790,0,2477,7313,1683286,2534412
334,9894,0,2480,7414,1712574,2531590
335,9678,0,2449,7229,1694118,2530891
336,9721,0,2433,7288,1696859,2537207
337,9660,0,2390,7270,1698645,2535189
338,9752,0,2395,7357,1734391,2529827
339,9622,0,2365,7257,1723410,2527228
340,9713,0,2400,7313,1708112,2532315
341,9747,0,2489,7258,1714192,2534590
342,9819,0,2503,7316,1699607,2535828
343,9684,0,2453,7231,1684644,2535466
344,9706,0,2405,7301,1709932,2526723
345,9779,0,2452,7327,1698821,2537745
346,9644,0,2409,7235,1690173,2534167
347,9583,0,2349,7234,1694094,2533272
348,9690,0,2413,7277,1695659,2534092
349,9666,0,2411,7255,1693328,2534516
350,9553,0,2361,7192,1683386,2537182
351,9831,0,2422,7409,1723373,2534403
352,9885,0,2449,7436,1743783,2531026
353,9736,0,2407,7329,1735432,2532326
354,9687,0,2422,7265,1713434,2529494
355,9830,0,2472,7358,1704876,2533423
356,9574,0,2449,7125,1716978,2529650
357,9860,0,2449,7411,1705760,2538486
358,9870,0,2370,7500,1720650,2536014
359,9798,0,2347,7451,1717602,2526245
360,9719,0,2370,7349,1706160,2535524
361,10208,0,2734,7474,1756811,2532459
362,10372,0,2432,7940,1774578,2533399
363,10181,0,2268,7913,1757724,2529066
364,10494,0,2276,8218,1763747,2529579
365,10240,0,2204,8036,1748787,2538043
366,10160,0,2154,8006,1731424,2532679
367,10352,0,2286,8066,1732203,2532476
368,10271,0,2263,8008,1745126,2532324
369,10064,0,2086,7978,1722190,2532059
370,10185,0,2133,8051,1725288,2527028
371,10062,0,2135,7928,1721302,2531838
372,10080,0,2160,7920,1723204,2531226
373,10255,0,2192,8063,1721262,2528732
374,10317,0,2217,8100,1715408,2531835
375,10200,0,2199,8001,1728644,2532744
376,10185,0,2176,8009,1736533,2528612
377,10110,0,2137,7973,1712710,2531262
378,10183,0,2160,8023,1719689,2534547
379,10268,0,2195,8073,1706251,2532425
380,10388,0,2219,8169,1733858,2530319
381,10311,0,2206,8105,1723502,2532089
382,10355,0,2201,8154,1707085,2530080
383,10346,0,2194,8152,1703262,2535091
384,10102,0,2075,8027,1704129,2529340
385,10192,0,2281,7911,1684622,2529692
386,10267,0,2158,8109,1690975,2531898
387,10228,0,2127,8101,1685591,2528621
388,10265,0,2319,7946,1687236,2532324
389,10307,0,2226,8081,1695316,2527073
390,10225,0,2218,8007,1681786,2531858
391,10085,0,2134,7951,1676489,2530522
392,10098,0,2100,7998,1666654,2528552
393,10131,0,2120,8011,1667812,2533061
394,10304,0,2193,8111,1693131,2531457
395,10160,0,2099,8061,1681479,2533663
396,10259,0,2276,7983,1705980,2531558
397,10357,0,2168,8189,1702353,2534977
398,10294,0,2177,8117,1694217,2533100
399,10256,0,2133,8123,1696250,2529678
400,10326,0,2160,8166,1706768,2532225
401,10250,0,2207,8043,1691207,2529197
402,10199,0,2197,8002,1693291,2527999
403,10226,0,2246,7980,1696985,2532385
404,10218,0,2243,7975,1700187,2532635
405,10141,0,2290,7851,1696389,2531976
406,10352,0,2235,8117,1709068,2533430
407,10396,0,2308,8088,1715211,2532588
408,10280,0,2222,8058,1682021,2534154
409,10144,0,2284,7860,1686814,2530645
410,10316,0,2292,8024,1707435,2525156
411,10240,0,2197,8043,1691809,2531907
412,10187,0,2236,7951,1688583,2535309
413,10195,0,2216,7979,1656257,2533079
414,10195,0,2134,8061,1657727,2537798
415,10242,0,2227,8015,1680421,2534029
416,10359,0,2199,8160,1693930,2535333
417,10378,0,2214,8164,1707232,2526812
418,10214,0,2265,7949,1693257,2532905
419,10319,0,2137,8182,1710016,2532673
420,10293,0,2156,8137,1682121,2529619
421,10966,0,2256,8710,1713928,2528862
422,11004,0,2216,8788,1687607,2527068
423,10926,0,2194,8732,1680860,2530576
424,10927,0,2145,8782,1656936,2533667
425,10859,0,2123,8736,1658804,2524935
426,11248,0,2254,8994,1693901,2534921
427,11006,0,2163,8843,1681117,2531817
428,11140,0,2203,8937,1675008,2530449
429,10984,0,2101,8883,1635261,2535551
430,10953,0,2056,8897,1645173,2534349
431,11089,0,2154,8935,1619308,2530737
432,10984,0,2184,8800,1618707,2531337
433,11042,0,2213,8829,1632970,2524262
434,11091,0,2183,8908,1647455,2532695
435,10748,0,2151,8597,1613940,2530350
436,10978,0,2212,8766,1605807,2531156
437,11046,0,2186,8860,1652890,2530141
438,11078,0,2247,8831,1631758,2535165
439,10939,0,2102,8837,1612158,2533944
440,11187,0,2159,9028,1645796,2532527
441,10979,0,2183,8796,1625516,2533384
442,10900,0,2244,8656,1602877,2533621
443,11044,0,2147,8897,1578999,2531399
444,10916,0,2132,8784,1602338,2535514
445,10997,0,2237,8760,1596841,2531646
446,11096,0,2201,8895,1587521,2534256
447,11041,0,2312,8729,1599258,2531080
448,11014,0,2072,8942,1589145,2528847
449,11053,0,2226,8827,1573987,2529958
450,11088,0,2227,8861,1580105,2530504
451,10982,0,2155,8827,1586417,2528514
452,10949,0,2149,8800,1570102,2533313
453,11097,0,2211,8886,1555717,2531911
454,11131,0,2201,8930,1601782,2529476
455,10988,0,2295,8693,1576635,2532972
456,10824,0,2163,8661,1563504,2535204
457,11063,0,2183,8880,1584801,2528532
458,11082,0,2218,8864,1587069,2531497
459,10938,0,2170,8768,1576769,2530580
460,10907,0,2190,8717,1582574,2529387
461,11154,0,2140,9014,1585818,2535613
462,11028,0,2176,8852,1586615,2531067
463,11095,0,2184,8911,1565728,2531418
464,10891,0,2135,8756,1541002,2533331
465,10907,0,2162,8745,1572934,2529010
466,10822,0,2052,8770,1527098,2535328
467,11241,0,2211,9030,1566171,2526678
468,10813,0,2162,8651,1564003,2532177
469,11093,0,2170,8923,1554655,2522937
470,11023,0,2146,8877,1555440,2532987
471,10938,0,2276,8662,1556698,2531807
472,10903,0,2202,8701,1552369,2529123
473,11054,0,2155,8899,1562356,2531736
474,11046,0,2276,8770,1554073,2536898
475,11113,0,2214,8899,1560519,2530685
476,11022,0,2121,8901,1561333,2536386
477,11010,0,2155,8855,1577837,2527799
478,11109,0,2205,8904,1582216,2533125
479,11189,0,2204,8985,1598861,2529496
480,11074,0,2215,8859,1584523,2530026
481,11141,0,2291,8850,1563446,2528393
482,11063,0,2224,8839,1557851,2532540
483,11060,0,2267,8793,1570618,2526328
484,11050,0,2243,8807,1560209,2532748
485,11027,0,2258,8769,1552845,2533910
486,11071,0,2265,8806,1551998,2534177
487,10985,0,2244,8741,1551253,2530485
488,11084,0,2237,8847,1558119,2531375
489,11137,0,2268,8869,1558959,2531153
490,10908,0,2242,8666,1547095,2531211
491,10892,0,2224,8668,1554475,2529884
492,10915,0,2224,8691,1572761,2534417
493,10983,0,2138,8845,1545490,2532318
494,11137,0,2238,8899,1567661,2531770
495,11092,0,2290,8802,1571749,2527730
496,10876,0,2217,8659,1542544,2531047
497,11387,0,2317,9070,1583410,2530612
498,11076,0,2252,8824,1550376,2530311
499,11005,0,2205,8800,1561552,2532166
500,10955,0,2175,8780,1530733,2535576
501,11141,0,2257,8884,1543164,2530243
502,10687,0,2094,8593,1521499,2528129
503,11212,0,2319,8893,1528153,2528350
504,10930,0,2119,8811,1534133,2529071
505,11282,0,2283,8999,1531844,2530144
506,10872,0,2181,8691,1509003,2534792
507,11237,0,2245,8992,1528672,2531347
508,10969,0,2246,8723,1526463,2532085
509,11158,0,2212,8946,1554329,2535525
510,11138,0,2210,8928,1547908,2532653
511,11119,0,2207,8912,1546007,2526967
512,11024,0,2270,8754,1523673,2525676
513,10964,0,2208,8756,1499972,2528909
514,11169,0,2223,8946,1526264,2532348
515,11156,0,2242,8914,1549566,2528677
516,11122,0,2229,8893,1541096,2532262
517,11113,0,2266,8847,1534774,2527883
518,11193,0,2219,8974,1555288,2530293
519,11155,0,2139,9016,1536382,2531606
520,10969,0,2203,8766,1516932,2527349
521,10991,0,2197,8794,1527749,2530097
522,10796,0,2171,8625,1532535,2528936
523,10971,0,2145,8826,1516035,2535740
524,11143,0,2236,8907,1524523,2531019
525,11034,0,2280,8754,1531877,2528699
526,11311,0,2289,9022,1531217,2531831
527,11027,0,2298,8729,1538530,2531729
528,11074,0,2244,8830,1538300,2528215
529,10983,0,2221,8762,1528812,2530655
530,11114,0,2305,8809,1564679,2532237
531,11140,0,2287,8853,1559374,2527961
532,11147,0,2249,8898,1534441,2534461
533,10933,0,2308,8625,1516624,2536291
534,11265,0,2263,9002,1550011,2530527
535,11092,0,2170,8922,1542936,2533599
536,11082,0,2369,8713,1514847,2532890
537,11047,0,2300,8747,1484494,2533170
538,11186,0,2265,8921,1518769,2529954
539,10955,0,2207,8748,1493967,2539090
540,11114,0,2220,8894,1507879,2525884
541,10656,0,2276,8380,1509544,2525591
542,10656,0,2303,8353,1517748,2531339
543,10736,0,2275,8461,1496078,2535347
544,10616,0,2194,8422,1506919,2530095
545,10661,0,2133,8528,1519028,2529806
546,10639,0,2176,8463,1508895,2530575
547,10569,0,2154,8415,1486901,2532232
548,10569,0,2203,8366,1500527,2526528
549,10546,0,2175,8371,1496195,2535911
550,10519,0,2194,8325,1477848,2526321
551,10777,0,2187,8590,1505949,2530309
552,10392,0,2154,8238,1493183,2531690
553,10375,0,2178,8197,1485880,2524863
554,10687,0,2202,8485,1509913,2529743
555,10665,0,2217,8448,1492915,2530942
556,10583,0,2111,8472,1501516,2534100
557,10618,0,2175,8443,1493636,2528349
558,10529,0,2208,8321,1500987,2529434
559,10633,0,2199,8434,1499341,2532373
560,10645,0,2199,8446,1508231,2525651
561,10541,0,2166,8375,1523628,2528070
562,10512,0,2110,8402,1513309,2531250
563,10528,0,2189,8339,1486027,2534236
564,10611,0,2163,8448,1517951,2528723
565,10607,0,2188,8419,1500094,2528635
566,10591,0,2228,8363,1513249,2533113
567,10557,0,2144,8413,1497980,2528180
568,10607,0,2166,8441,1519467,2528742
569,10684,0,2183,8501,1512211,2532960
570,10476,0,2189,8287,1489379,2532627
571,10584,0,2137,8447,1499707,2534126
572,10628,0,2126,8502,1493553,2532417
573,10541,0,2122,8419,1484428,2530598
574,10543,0,2163,8380,1453461,2535195
575,10619,0,2238,8381,1480104,2534456
576,10437,0,2123,8314,1493603,2531284
577,10620,0,2191,8429,1465168,2534748
578,10543,0,2172,8371,1487480,2529195
579,10679,0,2149,8530,1488215,2531328
580,10645,0,2148,8497,1500514,2528989
581,10809,0,2239,8570,1513131,2531950
582,10605,0,2223,8382,1497500,2534960
583,10517,0,2145,8372,1483362,2534429
584,10604,0,2205,8399,1493088,2528300
585,10610,0,2195,8415,1479190,2535841
586,10651,0,2247,8404,1508647,2527662
587,10425,0,2144,8281,1453533,2533676
588,10592,0,2120,8472,1469277,2532551
589,10615,0,2153,8462,1476105,2534103
590,10704,0,2178,8526,1518615,2529452
591,10783,0,2189,8594,1485545,2533168
592,10546,0,2171,8375,1483669,2531315
593,10552,0,2194,8358,1485948,2532618
594,10566,0,2202,8364,1482829,2531559
595,10577,0,2205,8372,1489180,2531583
596,10640,0,2174,8466,1501419,2534234
597,10586,0,2158,8428,1516290,2530624
598,10670,0,2175,8495,1519036,2526818
599,10644,0,2177,8467,1506933,2528322
600,10660,0,2175,8485,1486204,2534433
601,9734,0,2857,6877,1462482,2534974
602,9672,0,2681,6991,1447874,2533367
603,9693,0,2686,7007,1476416,2534091
604,9842,0,2692,7150,1499601,2534712
605,9774,0,2587,7187,1524782,2537555
606,9828,0,2514,7314,1521285,2535468
607,9711,0,2559,7152,1533590,2533089
608,9901,0,2615,7286,1534443,2533557
609,9728,0,2533,7195,1537161,2533413
610,9836,0,2612,7224,1530769,2530314
611,9885,0,2553,7332,1555518,2535387
612,9746,0,2593,7153,1556298,2534603
613,9861,0,2503,7358,1550997,2534808
614,9811,0,2567,7244,1575354,2531911
615,9657,0,2524,7133,1540294,2535168
616,9726,0,2457,7269,1551388,2531295
617,9754,0,2599,7155,1551395,2536402
618,9826,0,2568,7258,1560268,2535028
619,9741,0,2503,7238,1557211,2532458
620,9770,0,2543,7227,1568774,2535164
621,9667,0,2532,7135,1569211,2536997
622,9784,0,2496,7288,1586549,2529362
623,9631,0,2553,7078,1567329,2535469
624,9731,0,2545,7186,1560586,2534521
625,9543,0,2529,7014,1566842,2535148
626,9783,0,2581,7202,1587277,2534499
627,9859,0,2606,7253,1556745,2532021
628,9786,0,2566,7220,1596627,2526498
629,9644,0,2556,7088,1591364,2529289
630,9889,0,2639,7250,1618514,2536250
631,9887,0,2580,7307,1625004,2534036
632,9751,0,2473,7278,1590588,2534583
633,9808,0,2486,7322,1586805,2535017
634,9879,0,2493,7386,1633014,2533471
635,9728,0,2616,7112,1593631,2536086
636,9769,0,2535,7234,1585835,2534662
637,9795,0,2625,7170,1568772,2533646
638,9855,0,2553,7302,1568566,2535131
639,9848,0,2575,7273,1607803,2536771
640,9635,0,2533,7102,1610617,2537388
641,9724,0,2619,7105,1609566,2531484
642,9883,0,2556,7327,1618376,2531011
643,9776,0,2478,7298,1617629,2532013
644,9848,0,2493,7355,1626824,2533938
645,9628,0,2522,7106,1599075,2532115
646,9891,0,2594,7297,1599632,2536897
647,9897,0,2520,7377,1619556,2532401
648,9902,0,2578,7324,1623813,2530406
649,9748,0,2524,7224,1600070,2533714
650,9554,0,2500,7054,1593266,2534026
651,9756,0,2581,7175,1598439,2531931
652,9726,0,2513,7213,1589159,2531550
653,9762,0,2544,7218,1609762,2528018
654,9704,0,2516,7188,1618484,2536755
655,9674,0,2448,7226,1626676,2534999
656,9680,0,2477,7203,1595932,2534358
657,9646,0,2602,7044,1597477,2535653
658,9586,0,2552,7034,1577045,2537982
659,9751,0,2564,7187,1587818,2530976
660,9722,0,2548,7174,1603928,2531864
661,8737,0,2303,6434,1572032,2530359
662,8643,0,2266,6377,1542714,2533864
663,8751,0,2139,6612,1543150,2537496
664,8595,0,2078,6517,1506757,2536864
665,8690,0,2086,6604,1524152,2529376
666,8714,0,2154,6560,1554587,2537530
667,8859,0,2107,6752,1566456,2530800
668,8675,0,2073,6602,1541379,2533955
669,8689,0,2235,6454,1534458,2535318
670,8689,0,2094,6595,1553237,2524524
671,8761,0,2094,6667,1565374,2531824
672,8786,0,2172,6614,1527769,2535746
673,8568,0,2033,6535,1538811,2531007
674,8878,0,2178,6700,1560644,2532403
675,8622,0,2047,6575,1535942,2531318
676,8806,0,2103,6703,1552214,2530683
677,8597,0,2068,6529,1545479,2539076
678,8602,0,2063,6539,1550055,2532520
679,8643,0,2102,6541,1526829,2533211
680,8615,0,2105,6510,1532400,2533014
681,8726,0,2137,6589,1547631,2528916
682,8847,0,2094,6753,1538523,2535337
683,8684,0,2149,6535,1553670,2533481
684,8634,0,2044,6590,1529099,2525276
685,8676,0,2128,6548,1533392,2532310
686,8880,0,2174,6706,1551264,2530270
687,8718,0,2135,6583,1538084,2530805
688,8596,0,2013,6583,1527451,2532208
689,8650,0,2148,6502,1511603,2534474
690,8547,0,2043,6504,1519056,2529369
691,8827,0,2142,6685,1556186,2531973
692,8678,0,2121,6557,1522293,2539062
693,8648,0,2040,6608,1528350,2532777
694,8805,0,2116,6689,1526615,2532035
695,8570,0,2099,6471,1533814,2533564
696,8775,0,2183,6592,1515208,2534986
697,8553,0,2084,6469,1535851,2531543
698,8720,0,2154,6566,1538051,2532065
699,8672,0,2141,6531,1519746,2538347
700,8577,0,2106,6471,1517039,2536462
701,8647,0,2156,6491,1527609,2531432
702,8687,0,2154,6533,1522800,2534512
703,8602,0,2057,6545,1519660,2527511
704,8647,0,2230,6417,1515632,2533860
705,8899,0,2241,6658,1532586,2534234
706,8649,0,2126,6523,1503806,2531482
707,8691,0,2117,6574,1512209,2529315
708,8791,0,2174,6617,1515735,2533224
709,8706,0,1980,6726,1515280,2523365
710,8574,0,2066,6508,1484575,2533215
711,8773,0,2192,6581,1470941,2537192
712,8670,0,2111,6559,1486507,2531867
713,8674,0,2148,6526,1536000,2532257
714,8723,0,2028,6695,1516022,2530925
715,8707,0,2097,6610,1516335,2528908
716,8584,0,2095,6489,1529464,2530568
717,8662,0,2068,6594,1522170,2527974
718,8766,0,2119,6647,1523481,2533044
719,8845,0,2189,6656,1539078,2532031
720,8828,0,2124,6704,1543888,2534470
721,8896,0,2324,6572,1538415,2532841
722,8954,0,2280,6674,1540828,2531129
723,8873,0,2183,6690,1537763,2532901
724,9162,0,2245,6917,1570426,2532669
725,9067,0,2161,6906,1615350,2528590
726,8806,0,2100,6706,1600120,2533843
727,8995,0,2146,6849,1622457,2531522
728,8921,0,2133,6788,1638617,2534374
729,9042,0,2214,6828,1628124,2531673
730,9000,0,2105,6895,1627227,2531495
731,8981,0,2157,6824,1615562,2534842
732,9093,0,2183,6910,1623687,2534456
733,9162,0,2176,6986,1623359,2532882
734,8865,0,2112,6753,1603554,2531001
735,9053,0,2118,6935,1610920,2528325
736,8869,0,2157,6712,1598330,2535233
737,8928,0,2149,6779,1614157,2533275
738,9114,0,2142,6972,1626194,2530887
739,9060,0,2193,6867,1643726,2537894
740,9025,0,2208,6817,1646423,2531036
741,8804,0,2125,6679,1616576,2527717
742,9087,0,2276,6811,1608922,2533594
743,8940,0,2260,6680,1632787,2532688
744,8806,0,2130,6676,1604133,2530848
745,9056,0,2180,6876,1617308,2536448
746,8966,0,2185,6781,1615766,2530780
747,8922,0,2145,6777,1614331,2533974
748,8892,0,2128,6764,1595661,2528649
749,8818,0,2200,6618,1586348,2531345
750,8903,0,2097,6806,1598944,2531626
751,8898,0,2143,6755,1575030,2528334
752,8887,0,2141,6746,1587100,2528233
753,9113,0,2193,6920,1602204,2533467
754,9086,0,2124,6962,1613751,2526009
755,8949,0,2120,6829,1597659,2533777
756,8805,0,2170,6635,1577669,2534654
757,8904,0,2139,6765,1586448,2530937
758,8837,0,2155,6682,1602736,2529987
759,9079,0,2187,6892,1615154,2534413
760,8855,0,2168,6687,1608427,2533364
761,9025,0,2142,6883,1609426,2537536
762,8869,0,2103,6766,1595425,2534025
763,8875,0,2187,6688,1583044,2529412
764,8867,0,2249,6618,1571808,2533221
765,8968,0,2157,6811,1595666,2534878
766,9152,0,2130,7022,1618044,2536958
767,9037,0,2154,6883,1623772,2529249
768,9236,0,2211,7025,1601148,2531473
769,9012,0,2182,6830,1609461,2536729
770,8957,0,2132,6825,1615763,2531824
771,9036,0,2137,6899,1618869,2537026
772,8861,0,2101,6760,1611856,2529635
773,9011,0,2093,6918,1609401,2532071
774,9056,0,2160,6896,1643203,2532255
775,9000,0,2213,6787,1618267,2534493
776,8954,0,2183,6771,1598133,2528218
777,8926,0,2226,6700,1603917,2536295
778,8998,0,2169,6829,1603593,2530670
779,8912,0,2177,6735,1587397,2534048
780,9063,0,2259,6804,1633578,2529739
781,9051,0,2120,6931,1634158,2533637
782,9019,0,2113,6906,1656893,2533597
783,9048,0,2089,6959,1670266,2533052
784,9021,0,2046,6975,1708018,2530327
785,8945,0,2010,6935,1695582,2530936
786,9052,0,2043,7009,1704500,2528983
787,8866,0,1999,6867,1736611,2529482
788,8934,0,2118,6816,1728955,2527649
789,8984,0,2079,6905,1734810,2530486
790,8951,0,2064,6887,1746024,2535428
791,8853,0,2006,6847,1759321,2532544
792,8868,0,2080,6788,1745233,2533937
793,8884,0,1981,6903,1717715,2527879
794,8843,0,2047,6796,1719223,2532041
795,8965,0,2018,6947,1723530,2535018
796,8872,0,2056,6816,1722062,2532976
797,8863,0,2061,6802,1737671,2529665
798,9018,0,2078,6940,1751056,2533998
799,8954,0,2093,6861,1755082,2531414
800,9164,0,2027,7137,1761630,2533790
801,8890,0,2010,6880,1728918,2534896
802,9022,0,2096,6926,1721898,2531628
803,9143,0,2112,7031,1753274,2531264
804,8945,0,2073,6872,1732115,2535037
805,8986,0,2070,6916,1735366,2533140
806,9035,0,2100,6935,1718689,2532424
807,8967,0,2149,6818,1719175,2529285
808,8895,0,2080,6815,1730503,2531219
809,9050,0,2047,7003,1773400,2524349
810,8917,0,2015,6902,1745564,2527670
811,8996,0,2043,6953,1759913,2526093
812,8967,0,2058,6909,1756417,2530647
813,9140,0,2114,7026,1751832,2533931
814,8924,0,2065,6859,1746932,2533641
815,8793,0,2073,6720,1718262,2531517
816,8910,0,2033,6877,1741347,2529881
817,8855,0,1980,6875,1721994,2536580
818,8936,0,2040,6896,1720631,2532134
819,9078,0,2074,7004,1732264,2534848
820,8991,0,2097,6894,1737392,2530073
821,8896,0,1974,6922,1733766,2530595
822,8976,0,1993,6983,1734539,2537987
823,9063,0,2135,6928,1724077,2532513
824,8794,0,2045,6749,1732890,2536159
825,9029,0,2082,6947,1756618,2532612
826,9087,0,2052,7035,1744423,2532114
827,8875,0,2104,6771,1736684,2536535
828,9012,0,2089,6923,1746521,2529660
829,8944,0,2073,6871,1745798,2539543
830,8975,0,2011,6964,1758534,2529606
831,8967,0,2059,6908,1742965,2529919
832,8865,0,2037,6828,1739682,2522409
833,8967,0,2160,6807,1717107,2535134
834,8945,0,2108,6837,1728765,2532054
835,9031,0,2046,6985,1753161,2531630
836,8962,0,2166,6796,1738426,2531685
837,8804,0,1989,6815,1728660,2532398
838,8826,0,2022,6804,1721842,2535296
839,9001,0,2059,6942,1720033,2532536
840,8851,0,2054,6797,1726997,2537026
841,8905,0,2152,6753,1741285,2534232
842,9115,0,2235,6880,1795754,2527248
843,8794,0,2226,6567,1801873,2531292
844,9163,0,2343,6821,1882134,2525886
845,9095,0,2339,6756,1908922,2534793
846,9045,0,2269,6776,1966776,2528423
847,9208,0,2284,6924,2030920,2524363
848,8941,0,2211,6730,2004811,2536133
849,8859,0,2147,6712,2002279,2532583
850,8986,0,2156,6830,1998788,2529229
851,9073,0,2223,6850,2011092,2535124
852,9007,0,2163,6844,2029133,2523823
853,9076,0,2177,6899,2015764,2534201
854,8886,0,2115,6771,2012463,2533805
855,8940,0,2102,6838,2026804,2531523
856,8841,0,2189,6652,2039582,2532895
857,9074,0,2230,6844,2051887,2533336
858,9043,0,2122,6921,2087044,2528445
859,9081,0,2189,6892,2070947,2532482
860,9013,0,2132,6881,2062998,2527772
861,8958,0,2096,6862,2082753,2535798
862,8915,0,2141,6774,2079779,2532832
863,8968,0,2132,6836,2055745,2524327
864,8901,0,2064,6837,2046666,2535712
865,9075,0,2218,6857,2047211,2532390
866,8986,0,2212,6774,2058495,2530552
867,9111,0,2226,6885,2050976,2535472
868,8872,0,2135,6737,2018086,2532186
869,8992,0,2174,6818,2001177,2533669
870,9044,0,2187,6857,2032706,2532320
871,8926,0,2158,6768,2025656,2534812
872,9112,0,2140,6972,2031119,2534894
873,8923,0,2109,6814,2028918,2529377
874,9001,0,2173,6828,2046252,2529355
875,8968,0,2199,6769,2038527,2533511
876,8861,0,2130,6731,2050322,2532836
877,8804,0,2101,6703,2045950,2527831
878,9169,0,2180,6989,2068457,2530100
879,9042,0,2169,6873,2078708,2530045
880,9091,0,2150,6941,2064693,2529577
881,9143,0,2163,6980,2053233,2529849
882,9159,0,2190,6969,2087112,2531909
883,8972,0,2182,6790,2061140,2528984
884,8946,0,2163,6783,2062663,2534015
885,9002,0,2236,6766,2091304,2532876
886,9064,0,2273,6791,2101671,2532472
887,9010,0,2226,6784,2074229,2533245
888,8965,0,2188,6777,2055224,2535011
889,8974,0,2161,6813,2065473,2531993
890,9085,0,2181,6904,2080265,2527707
891,9076,0,2136,6940,2088697,2532588
892,8976,0,2118,6858,2069523,2531663
893,8958,0,2122,6836,2057182,2532026
894,9032,0,2154,6878,2069414,2529569
895,9101,0,2077,7024,2107073,2526484
896,8993,0,2112,6881,2077204,2526012
897,8987,0,2125,6862,2055662,2532442
898,8875,0,2060,6815,2073688,2532032
899,9032,0,2136,6896,2080571,2534309
900,9098,0,2187,6911,2100626,2532168
901,9731,0,2559,7172,2095641,2530652
902,9667,0,2419,7248,2083615,2533112
903,9488,0,2352,7136,2067219,2533696
904,9780,0,2487,7293,2109449,2530354
905,9635,0,2480,7155,2096016,2533455
906,9675,0,2460,7215,2103481,2533559
907,9590,0,2455,7135,2070714,2537228
908,9481,0,2400,7081,2071491,2534596
909,9510,0,2468,7042,2062312,2531656
910,9677,0,2431,7246,2055155,2538371
911,9649,0,2495,7154,2112843,2530266
912,9580,0,2500,7080,2093213,2535552
913,9593,0,2487,7106,2105783,2533557
914,9505,0,2387,7118,2083138,2533999
915,9544,0,2409,7135,2097393,2530233
916,9737,0,2477,7260,2081232,2536851
917,9640,0,2501,7139,2100615,2530598
918,9351,0,2444,6907,2092989,2532582
919,9702,0,2551,7151,2101369,2537675
920,9619,0,2478,7141,2117253,2536488
921,9684,0,2481,7203,2105828,2531762
922,9641,0,2478,7163,2105147,2538604
923,9547,0,2429,7118,2103423,2539262
924,9498,0,2443,7055,2090079,2534075
925,9643,0,2563,7080,2097735,2531647
926,9522,0,2467,7055,2105153,2533384
927,9731,0,2524,7207,2135734,2531040
928,9509,0,2378,7131,2127274,2537277
929,9643,0,2490,7153,2099612,2537217
930,9573,0,2472,7101,2092002,2537273
931,9580,0,2450,7130,2101403,2531409
932,9478,0,2479,6999,2093325,2536526
933,9507,0,2410,7097,2089163,2536160
934,9613,0,2441,7172,2118905,2534047
935,9472,0,2473,6999,2076208,2538017
936,9697,0,2475,7222,2093623,2530577
937,9552,0,2435,7117,2108840,2536017
938,9464,0,2394,7070,2090476,2532829
939,9743,0,2482,7261,2097381,2536058
940,9668,0,2460,7208,2095081,2535519
941,9585,0,2368,7217,2091579,2531605
942,9705,0,2496,7209,2102099,2532671
943,9564,0,2391,7173,2108035,2534733
944,9560,0,2385,7175,2092053,2531664
945,9606,0,2389,7217,2048296,2532279
946,9346,0,2388,6958,2065055,2532390
947,9588,0,2412,7176,2060422,2536737
948,9527,0,2533,6994,2067966,2529129
949,9711,0,2481,7230,2072301,2530355
950,9498,0,2532,6966,2063147,2531179
951,9667,0,2514,7153,2083233,2529990
952,9445,0,2470,6975,2067737,2535902
953,9595,0,2558,7037,2077235,2533074
954,9474,0,2493,6981,2087429,2530059
955,9495,0,2469,7026,2069783,2533854
956,9718,0,2441,7277,2092739,2532636
957,9561,0,2430,7131,2066020,2533811
958,9413,0,2303,7110,2065641,2529100
959,9419,0,2487,6932,2057341,2535113
960,9534,0,2414,7120,2058649,2536250
961,9032,0,2329,6703,2009203,2530527
962,9115,0,2293,6822,1936415,2530368
963,9230,0,2257,6973,1897720,2536588
964,9176,0,2363,6813,1804290,2534451
965,9134,0,2326,6808,1742739,2533359
966,9300,0,2328,6972,1691661,2536426
967,9207,0,2339,6868,1630769,2533673
968,8933,0,2179,6754,1602216,2536818
969,9219,0,2311,6908,1599836,2531513
970,9351,0,2199,7152,1588875,2538165
971,9346,0,2209,7137,1616156,2532833
972,9264,0,2253,7011,1607247,2532875
973,9291,0,2233,7058,1599323,2537827
974,9288,0,2213,7075,1612056,2535315
975,9159,0,2190,6969,1594155,2532872
976,9368,0,2248,7120,1606233,2532655
977,9182,0,2227,6955,1602553,2529870
978,9351,0,2193,7158,1624041,2531823
979,9392,0,2322,7070,1637245,2529862
980,9022,0,2193,6829,1594137,2530738
981,9145,0,2152,6993,1589129,2530258
982,9145,0,2264,6881,1590285,2539276
983,9346,0,2291,7055,1590252,2524099
984,9247,0,2285,6962,1581502,2534390
985,9155,0,2331,6824,1571812,2534680
986,9172,0,2210,6962,1569458,2536741
987,9187,0,2165,7022,1573455,2534699
988,9242,0,2243,6999,1562264,2531521
989,9238,0,2272,6966,1561563,2530520
990,9098,0,2132,6966,1573251,2529535
991,9239,0,2186,7053,1575304,2531973
992,9206,0,2233,6973,1557130,2530326
993,9325,0,2295,7030,1582074,2530477
994,9337,0,2263,7074,1557331,2538065
995,9233,0,2262,6971,1581499,2530824
996,9062,0,2193,6869,1551015,2532003
997,9249,0,2146,7103,1583085,2530715
998,9178,0,2202,6976,1564787,2536050
999,9201,0,2232,6969,1551770,2537019
1000,9108,0,2199,6909,1561130,2537206
1001,9211,0,2171,7040,1564053,2532937
1002,9247,0,2214,7033,1567407,2528715
1003,9160,0,2206,6954,1570664,2536234
1004,9122,0,2230,6892,1543145,2532327
1005,9127,0,2241,6886,1563247,2530310
1006,9238,0,2262,6976,1549521,2533333
1007,9216,0,2278,6938,1532202,2533456
1008,9134,0,2274,6860,1546420,2534408
1009,9096,0,2145,6951,1555293,2534377
1010,9277,0,2143,7134,1568814,2527248
1011,9165,0,2110,7055,1583246,2530408
1012,9259,0,2186,7073,1587447,2534978
1013,9342,0,2197,7145,1560390,2531296
1014,9193,0,2209,6984,1553028,2534234
1015,9098,0,2165,6933,1553469,2531936
1016,9184,0,2265,6919,1544144,2533135
1017,9139,0,2297,6842,1540622,2534000
1018,9277,0,2291,6986,1561820,2530085
1019,9295,0,2186,7109,1558463,2534971
1020,9207,0,2276,6931,1574077,2536103
1021,8711,0,2128,6583,1543687,2531194
1022,8754,0,2132,6622,1565443,2534986
1023,8900,0,2057,6843,1565264,2529456
1024,8709,0,2060,6649,1518929,2531650
1025,8793,0,2142,6651,1504477,2530896
1026,8836,0,2124,6712,1520527,2530250
1027,8793,0,2142,6651,1488028,2533305
1028,8815,0,2107,6708,1487443,2535384
1029,8774,0,2102,6672,1486313,2530999
1030,8716,0,2063,6653,1452159,2536707
1031,8830,0,2129,6701,1472020,2533125
1032,8769,0,2090,6679,1462235,2531115
1033,8706,0,2097,6609,1446580,2535184
1034,8830,0,2146,6684,1426980,2537218
1035,8663,0,2084,6579,1450365,2531334
1036,8929,0,2112,6817,1479984,2532229
1037,8764,0,2143,6621,1492173,2533994
1038,8938,0,2067,6871,1500754,2525116
1039,8634,0,2028,6606,1474991,2532927
1040,8649,0,2030,6619,1452509,2529619
1041,8572,0,1992,6580,1466176,2528762
1042,8840,0,2095,6745,1505557,2524651
1043,8784,0,2096,6688,1523057,2528256
1044,8643,0,2024,6619,1510553,2529234
1045,8738,0,2102,6636,1460204,2534710
1046,8679,0,2091,6588,1437401,2528238
1047,8716,0,2010,6706,1477086,2530692
1048,8662,0,2061,6601,1475013,2532880
1049,8766,0,2063,6703,1456449,2529447
1050,8700,0,2093,6607,1466311,2532781
1051,8730,0,2105,6625,1462872,2533337
1052,9041,0,2206,6835,1457801,2532947
1053,8643,0,1993,6650,1456990,2534472
1054,8912,0,2144,6768,1482983,2530241
1055,8861,0,2131,6730,1466515,2534898
1056,8915,0,2148,6767,1471253,2535988
1057,8702,0,2087,6615,1476340,2527542
1058,8915,0,2062,6853,1507054,2529388
1059,8698,0,2031,6667,1478517,2533840
1060,8754,0,2067,6687,1465321,2531656
1061,8617,0,2092,6525,1452883,2532035
1062,8795,0,2088,6707,1475829,2534822
1063,8807,0,2119,6688,1486758,2530762
1064,8554,0,2018,6536,1459850,2530458
1065,8738,0,2129,6609,1460490,2532703
1066,8895,0,2175,6720,1497242,2527491
1067,8868,0,2172,6696,1486167,2539103
1068,9010,0,2141,6869,1498954,2532996
1069,8662,0,2034,6628,1476380,2531744
1070,8630,0,2022,6608,1450811,2533149
1071,8838,0,2085,6753,1470343,2528931
1072,8821,0,2117,6704,1459941,2532734
1073,8691,0,2052,6639,1458845,2533784
1074,8766,0,2002,6764,1458545,2533141
1075,8554,0,2028,6526,1455233,2530937
1076,8737,0,2093,6644,1466560,2531723
1077,8703,0,2064,6639,1471041,2534085
1078,8691,0,2084,6607,1460909,2534037
1079,8722,0,2146,6576,1438857,2532042
1080,8909,0,2074,6835,1462543,2533612
1081,8918,0,2091,6827,1486390,2532619
1082,8807,0,2095,6712,1477773,2533208
1083,8540,0,1937,6603,1461297,2529219
1084,8775,0,1977,6798,1492672,2526219
1085,8807,0,1966,6841,1495321,2528527
1086,8879,0,2081,6798,1481996,2533279
1087,8787,0,2037,6750,1488365,2526769
1088,8885,0,2059,6826,1493571,2530745
1089,8670,0,1978,6692,1464044,2538613
1090,8722,0,2115,6607,1451492,2535914
1091,8681,0,1992,6689,1448753,2532996
1092,8774,0,2067,6707,1462015,2529024
1093,8841,0,1992,6849,1487297,2529507
1094,8883,0,1985,6898,1509604,2530395
1095,8677,0,1973,6704,1462956,2535841
1096,8751,0,2005,6746,1445825,2531838
1097,8757,0,2009,6748,1454536,2530068
1098,8744,0,1990,6754,1473714,2527293
1099,8736,0,1988,6748,1478684,2528556
1100,8789,0,2009,6780,1444171,2532579
1101,8775,0,1993,6782,1453570,2529957
1102,8768,0,2075,6693,1484168,2529685
1103,8926,0,2057,6869,1468172,2531917
1104,8886,0,2184,6702,1463457,2524314
1105,8904,0,2112,6792,1464431,2531787
1106,8749,0,2082,6667,1442694,2531042
1107,8779,0,2118,6661,1469150,2530836
1108,8771,0,2089,6682,1458208,2535966
1109,8849,0,2137,6712,1467123,2532925
1110,8724,0,2045,6679,1449887,2535194
1111,8795,0,2042,6753,1455870,2531893
1112,8718,0,2072,6646,1428006,2533523
1113,8643,0,2031,6612,1435272,2536127
1114,8834,0,1995,6839,1443313,2531787
1115,8692,0,2081,6611,1431479,2530365
1116,8787,0,2093,6694,1456822,2527654
1117,8774,0,2036,6738,1468224,2531137
1118,8628,0,1971,6657,1443249,2531375
1119,8871,0,2075,6796,1465400,2535246
1120,8824,0,2029,6795,1481336,2533632
1121,8655,0,1933,6722,1449267,2534568
1122,8537,0,1969,6568,1413063,2534743
1123,8804,0,2084,6720,1458702,2530477
1124,8779,0,2061,6718,1455839,2535335
1125,8798,0,2134,6664,1447719,2533661
1126,8585,0,1995,6590,1461768,2527047
1127,8660,0,1978,6682,1460087,2532258
1128,8859,0,2021,6838,1477036,2527997
1129,8672,0,2028,6644,1444771,2532899
1130,8779,0,2008,6771,1452436,2530846
1131,8662,0,2045,6617,1463674,2533085
1132,8801,0,2023,6778,1462214,2531375
1133,8703,0,2013,6690,1464512,2526114
1134,8643,0,1964,6679,1459890,2530141
1135,8867,0,2059,6808,1457444,2529488
1136,8740,0,2043,6697,1456927,2529830
1137,8886,0,2058,6828,1472014,2535282
1138,8846,0,2092,6754,1489124,2528787
1139,8811,0,2064,6747,1474558,2528294
1140,8757,0,2004,6753,1449497,2534806
1141,8591,0,1963,6628,1455076,2531356
1142,8729,0,1976,6753,1458869,2531006
1143,8550,0,1948,6602,1444686,2530164
1144,8695,0,2014,6681,1454728,2530476
1145,8552,0,1931,6621,1479477,2522945
1146,8645,0,1911,6734,1452800,2527809
1147,8661,0,2006,6655,1427907,2530003
1148,8576,0,1954,6622,1432544,2532851
1149,8525,0,1913,6612,1460377,2527388
1150,8736,0,2025,6711,1468772,2526560
1151,8592,0,1939,6653,1442647,2532097
1152,8605,0,1959,6646,1430423,2533625
1153,8473,0,1881,6592,1416611,2536810
1154,8784,0,1962,6822,1455508,2530247
1155,8634,0,1865,6769,1447480,2532986
1156,8570,0,1869,6701,1437446,2533840
1157,8570,0,1978,6592,1432825,2535763
1158,8547,0,1913,6634,1445772,2530711
1159,8624,0,1914,6710,1433434,2532114
1160,8629,0,1913,6716,1446284,2533406
1161,8746,0,1974,6772,1445652,2529005
1162,8600,0,1884,6716,1431046,2528505
1163,8627,0,1971,6656,1440810,2528258
1164,8763,0,1900,6863,1469721,2534576
1165,8826,0,1952,6874,1463978,2534529
1166,8788,0,2017,6771,1461313,2535456
1167,8694,0,2015,6679,1436169,2531406
1168,8663,0,2006,6657,1441399,2532363
1169,8619,0,1998,6621,1428645,2534948
1170,8524,0,1965,6559,1432837,2529641
1171,8703,0,2021,6682,1448366,2530554
1172,8559,0,1916,6643,1424934,2534851
1173,8785,0,2096,6689,1443116,2530591
1174,8668,0,1875,6793,1458832,2526639
1175,8576,0,1820,6756,1438548,2531081
1176,8596,0,1997,6599,1438987,2530628
1177,8739,0,1901,6838,1436973,2530379
1178,8562,0,1951,6611,1451532,2530885
1179,8559,0,1903,6656,1442705,2531288
1180,8703,0,1930,6773,1449415,2532682
1181,8581,0,1919,6662,1437677,2531710
1182,8592,0,1927,6665,1468495,2534336
1183,8579,0,1891,6688,1450516,2532366
1184,8632,0,1940,6692,1446498,2533431
1185,8495,0,1891,6604,1445354,2532327
1186,8523,0,2006,6517,1419710,2533612
1187,8813,0,1992,6821,1442753,2528525
1188,8494,0,1950,6544,1433732,2533161
1189,8466,0,1895,6571,1417144,2532546
1190,8600,0,1864,6736,1444160,2533159
1191,8517,0,1951,6566,1444397,2536148
1192,8538,0,1951,6587,1433347,2533097
1193,8592,0,1972,6620,1421440,2535186
1194,8466,0,1926,6540,1432551,2528029
1195,8786,0,1993,6793,1443117,2533065
1196,8737,0,1954,6783,1423740,2534966
1197,8545,0,1905,6640,1434346,2534220
1198,8538,0,1861,6677,1424601,2533119
1199,8673,0,1920,6753,1448157,2533985
1200,8866,0,2005,6861,1453136,2531088
1201,9241,0,2641,6600,1471617,2532348
1202,9295,0,2453,6842,1500387,2531110
1203,9221,0,2359,6862,1492149,2534345
1204,9253,0,2391,6862,1517780,2536040
1205,9264,0,2374,6890,1514545,2537881
1206,9207,0,2443,6764,1509185,2531865
1207,9191,0,2422,6769,1516424,2536077
1208,9195,0,2380,6815,1533087,2530318
1209,9119,0,2385,6734,1525621,2536444
1210,9272,0,2392,6880,1513132,2535892
1211,9160,0,2399,6761,1514210,2535391
1212,9334,0,2385,6949,1561128,2532694
1213,9113,0,2317,6796,1560627,2537444
1214,9102,0,2351,6751,1546401,2532054
1215,9116,0,2369,6747,1529862,2528827
1216,9283,0,2398,6885,1558392,2528840
1217,9136,0,2324,6812,1562914,2535516
1218,9220,0,2481,6739,1545749,2536586
1219,9094,0,2351,6743,1548714,2529508
1220,9147,0,2417,6730,1556063,2536141
1221,9307,0,2380,6927,1588046,2533650
1222,9322,0,2418,6904,1592200,2533901
1223,9407,0,2367,7040,1615139,2529630
1224,9215,0,2261,6954,1594681,2538376
1225,9241,0,2397,6844,1585541,2531688
1226,9526,0,2509,7017,1613685,2532250
1227,9153,0,2321,6832,1605832,2532721
1228,9119,0,2379,6740,1597079,2536887
1229,9216,0,2414,6802,1586889,2533754
1230,9251,0,2392,6859,1600169,2538644
1231,9239,0,2355,6884,1621994,2536170
1232,9155,0,2446,6709,1594422,2534796
1233,9289,0,2498,6791,1586162,2534627
1234,9244,0,2389,6855,1614723,2532297
1235,9215,0,2392,6823,1635983,2535143
1236,9229,0,2427,6802,1607901,2535622
1237,9095,0,2421,6674,1570507,2533083
1238,9132,0,2432,6700,1596009,2531685
1239,9372,0,2407,6965,1619458,2536315
1240,9216,0,2372,6844,1601483,2531353
1241,9136,0,2387,6749,1602780,2535382
1242,9383,0,2537,6846,1613635,2534394
1243,9243,0,2443,6800,1648710,2530971
1244,9231,0,2476,6755,1627337,2532090
1245,9128,0,2368,6760,1613468,2535338
1246,9323,0,2340,6983,1629581,2534377
1247,9292,0,2392,6900,1592435,2538209
1248,9261,0,2484,6777,1604684,2532509
1249,9380,0,2350,7030,1615242,2532508
1250,9152,0,2368,6784,1590034,2532800
1251,9066,0,2308,6758,1611983,2537387
1252,9270,0,2471,6799,1623684,2532578
1253,9218,0,2420,6798,1637142,2533594
1254,9195,0,2443,6752,1611273,2542756
1255,9263,0,2417,6846,1627811,2532151
1256,9279,0,2519,6760,1658144,2532099
1257,9135,0,2450,6685,1624603,2539461
1258,9397,0,2508,6889,1626585,2535468
1259,9355,0,2374,6981,1647996,2531103
1260,9316,0,2438,6878,1646633,2535996
1261,8745,0,2191,6554,1625658,2536646
1262,8873,0,2159,6714,1617838,2533942
1263,8607,0,2042,6565,1578561,2533519
1264,8907,0,2082,6825,1586504,2531654
1265,8799,0,1954,6845,1573865,2532131
1266,8753,0,2145,6608,1578463,2533275
1267,8884,0,2049,6835,1574903,2532782
1268,8820,0,2069,6751,1570853,2528858
1269,8752,0,2004,6748,1570754,2537150
1270,8625,0,1901,6724,1551309,2531232
1271,8813,0,2025,6788,1559912,2528215
1272,8713,0,1981,6732,1562300,2531497
1273,8801,0,2041,6760,1529853,2533986
1274,8740,0,2012,6728,1523682,2537579
1275,8745,0,2083,6662,1547159,2528603
1276,8783,0,2053,6730,1536302,2535372
1277,8722,0,1945,6777,1543639,2527220
1278,8778,0,2026,6752,1533999,2533700
1279,8803,0,2006,6797,1543631,2528560
1280,8834,0,2124,6710,1540600,2534595
1281,8734,0,2052,6682,1522739,2533102
1282,8790,0,2078,6712,1515951,2534530
1283,8908,0,2117,6791,1528459,2534470
1284,8743,0,1959,6784,1530485,2532088
1285,8879,0,1987,6892,1543152,2531848
1286,8612,0,1945,6667,1527469,2533239
1287,8806,0,2000,6806,1518591,2531287
1288,8910,0,2071,6839,1524763,2532077
1289,8783,0,2041,6742,1526871,2533791
1290,8768,0,2084,6684,1506787,2529449
1291,8863,0,2062,6801,1543304,2533527
1292,8751,0,1933,6818,1522781,2535866
1293,8639,0,2010,6629,1509574,2534550
1294,8531,0,1994,6537,1499059,2534833
1295,8715,0,2072,6643,1508808,2531473
1296,8666,0,1988,6678,1502267,2531469
1297,8827,0,2060,6767,1523447,2526223
1298,8764,0,2103,6661,1500025,2535533
1299,8707,0,1979,6728,1512981,2531932
1300,8800,0,2098,6702,1527095,2530369
1301,8868,0,2045,6823,1531948,2530425
1302,8767,0,1999,6768,1529188,2527325
1303,8858,0,2110,6748,1530567,2531064
1304,8697,0,2009,6688,1527189,2527909
1305,8734,0,1942,6792,1517963,2526475
1306,8905,0,2053,6852,1521356,2532786
1307,8789,0,2061,6728,1536756,2533598
1308,8718,0,2002,6716,1512134,2536967
1309,8683,0,2031,6652,1522135,2532841
1310,8908,0,1971,6937,1535886,2531278
1311,8859,0,2072,6787,1523142,2534893
1312,8805,0,2034,6771,1518557,2529315
1313,8785,0,1996,6789,1497231,2530170
1314,8849,0,2081,6768,1500259,2534414
1315,8692,0,2022,6670,1503413,2530250
1316,8855,0,2021,6833,1511712,2527717
1317,8765,0,1982,6784,1493721,2532317
1318,8666,0,1935,6730,1476793,2535291
1319,8766,0,2002,6765,1496624,2528632
1320,8777,0,2018,6759,1482620,2533185
1321,8681,0,1991,6690,1472820,2531957
1322,8722,0,1988,6734,1506991,2532664
1323,8592,0,1970,6622,1466793,2530322
1324,8578,0,1967,6611,1451102,2530727
1325,8841,0,1967,6874,1493493,2531390
1326,8665,0,1960,6705,1513277,2530143
1327,8708,0,1948,6760,1507473,2533796
1328,8637,0,1981,6656,1476110,2534213
1329,8566,0,2009,6557,1466307,2534699
1330,8838,0,2084,6754,1482720,2533778
1331,8743,0,1929,6814,1493952,2530421
1332,8695,0,2013,6682,1492546,2535851
1333,8675,0,1967,6708,1465654,2528618
1334,8584,0,1949,6635,1469285,2532025
1335,8660,0,1955,6705,1479601,2528653
1336,8698,0,2030,6668,1476994,2531770
1337,8544,0,1948,6596,1484971,2534145
1338,8667,0,1967,6700,1463320,2533575
1339,8653,0,2009,6644,1456747,2534171
1340,8689,0,2029,6660,1476162,2529171
1341,8701,0,1996,6704,1486232,2535726
1342,8599,0,1940,6660,1482137,2532586
1343,8745,0,1979,6766,1467962,2526708
1344,8770,0,1929,6841,1497885,2527296
1345,8564,0,1924,6640,1497207,2533935
1346,8671,0,1927,6744,1471298,2530723
1347,8613,0,2020,6593,1493843,2531241
1348,8641,0,1940,6701,1506767,2526827
1349,8857,0,1930,6927,1503021,2528282
1350,8774,0,1985,6789,1492331,2536976
1351,8654,0,2045,6609,1490000,2537255
1352,8574,0,1977,6597,1492427,2531891
1353,8725,0,2087,6638,1504126,2531452
1354,8580,0,1913,6667,1488237,2531999
1355,8700,0,1921,6779,1500051,2531782
1356,8529,0,1928,6601,1484973,2534051
1357,8738,0,2026,6712,1487626,2531271
1358,8607,0,1923,6684,1486463,2532847
1359,8612,0,1973,6639,1477079,2533647
1360,8586,0,1984,6602,1477100,2530709
1361,8652,0,1931,6721,1503289,2533015
1362,8730,0,2008,6722,1512669,2533579
1363,8633,0,1995,6638,1497788,2529960
1364,8704,0,1970,6734,1481833,2533496
1365,8664,0,1944,6720,1502532,2531294
1366,8663,0,1954,6709,1478511,2534440
1367,8598,0,1922,6676,1490066,2533369
1368,8577,0,1940,6637,1493464,2537950
1369,8580,0,1935,6645,1486204,2532363
1370,8764,0,1981,6783,1505330,2532793
1371,8599,0,1933,6666,1490202,2527664
1372,8705,0,1989,6716,1487045,2532903
1373,8724,0,1933,6791,1494171,2531202
1374,8661,0,1946,6715,1471108,2527081
1375,8824,0,2007,6817,1499054,2529692
1376,8642,0,1936,6706,1493290,2530056
1377,8515,0,1876,6639,1450295,2531664
1378,8500,0,1893,6607,1476108,2534616
1379,8693,0,1964,6729,1476983,2530048
1380,8749,0,2013,6736,1493540,2534616
1381,8935,0,1995,6940,1523568,2531179
1382,8931,0,2031,6900,1505674,2532818
1383,9022,0,2006,7016,1525900,2533216
1384,8858,0,2078,6780,1501986,2534183
1385,8899,0,2031,6868,1493929,2531223
1386,9112,0,2049,7063,1533200,2527491
1387,8752,0,2024,6728,1516370,2535860
1388,8979,0,1974,7005,1532665,2535972
1389,8885,0,1965,6920,1555519,2529062
1390,8935,0,2061,6874,1571775,2527349
1391,8898,0,1978,6920,1553272,2527596
1392,8988,0,1979,7009,1560065,2530083
1393,8915,0,1975,6940,1590214,2534857
1394,8928,0,1960,6968,1598660,2531445
1395,8922,0,2012,6910,1595013,2533230
1396,8881,0,1985,6896,1614907,2532669
1397,9029,0,2043,6986,1609024,2533559
1398,8930,0,2070,6860,1650341,2527974
1399,8876,0,1931,6945,1651688,2527581
1400,8906,0,1988,6918,1647203,2530524
1401,9014,0,2013,7001,1671209,2529002
1402,9247,0,2099,7148,1693478,2533587
1403,8870,0,1985,6885,1674969,2532060
1404,8778,0,1928,6850,1656854,2529346
1405,8983,0,2027,6956,1666055,2535975
1406,9004,0,1975,7029,1696464,2532036
1407,8873,0,2022,6851,1688365,2533461
1408,8937,0,1945,6992,1688778,2536883
1409,8899,0,2039,6860,1694178,2533937
1410,8919,0,2021,6898,1723405,2535495
1411,8942,0,1999,6943,1729016,2533223
1412,8869,0,1991,6878,1738757,2531322
1413,8919,0,2022,6897,1734620,2531736
1414,8766,0,2018,6748,1739645,2534534
1415,8932,0,1988,6944,1743797,2535307
1416,8994,0,2046,6948,1748730,2535804
1417,8801,0,1975,6826,1750446,2537574
1418,9054,0,1996,7058,1755600,2535281
1419,8885,0,1932,6953,1741381,2533672
1420,8906,0,1966,6940,1757821,2531059
1421,8721,0,1911,6810,1780441,2530818
1422,8780,0,1957,6823,1768137,2533116
1423,8958,0,2059,6899,1790123,2530769
1424,8986,0,2001,6985,1791716,2535884
1425,8847,0,1956,6891,1804800,2533141
1426,8876,0,2024,6852,1837227,2531709
1427,8949,0,1967,6982,1835739,2529083
1428,9115,0,1997,7118,1863607,2533147
1429,9045,0,1996,7049,1853623,2533320
1430,8959,0,1923,7036,1870993,2529172
1431,8828,0,1975,6853,1865324,2533622
1432,8809,0,1979,6830,1855638,2535813
1433,8911,0,2015,6896,1855094,2539084
1434,8977,0,1934,7043,1870421,2534245
1435,8791,0,1922,6869,1872278,2534305
1436,8829,0,2044,6785,1850179,2537084
1437,8849,0,1992,6857,1857572,2531759
1438,9004,0,2025,6979,1893799,2528760
1439,9043,0,2003,7040,1893875,2532618
1440,8817,0,1925,6892,1877095,2534208
1441,8597,0,2060,6537,1861418,2537561
1442,8593,0,2024,6569,1887923,2530096
1443,8652,0,2038,6614,1902231,2535053
1444,8651,0,1979,6672,1901306,2527119
1445,8756,0,2072,6684,1899919,2534891
1446,8715,0,2086,6629,1906609,2529499
1447,8504,0,1925,6579,1900737,2535207
1448,8632,0,2052,6580,1924865,2530660
1449,8693,0,1989,6704,1923122,2526320
1450,8533,0,1943,6590,1921307,2530993
1451,8528,0,1999,6529,1898367,2536474
1452,8474,0,1977,6497,1892138,2530205
1453,8538,0,1977,6561,1889775,2529568
1454,8498,0,1942,6556,1872084,2530918
1455,8460,0,1883,6577,1865632,2532158
1456,8615,0,1910,6705,1869222,2531907
1457,8647,0,1999,6648,1845854,2535887
1458,8337,0,1855,6482,1813619,2532262
1459,8715,0,2022,6693,1837177,2534772
1460,8690,0,1990,6700,1872959,2532544
1461,8603,0,1986,6617,1849228,2537099
1462,8635,0,1958,6677,1845634,2533471
1463,8529,0,1973,6556,1849556,2533950
1464,8493,0,1936,6557,1846832,2531320
1465,8674,0,1934,6740,1852557,2530916
1466,8375,0,1885,6490,1841206,2532810
1467,8679,0,2050,6629,1848436,2528463
1468,8687,0,2106,6581,1831882,2531142
1469,8629,0,1967,6662,1836526,2533071
1470,8477,0,2021,6456,1799669,2535442
1471,8732,0,2002,6730,1807521,2536668
1472,8543,0,1979,6564,1812998,2536407
1473,8549,0,1981,6568,1796469,2529198
1474,8735,0,1991,6744,1829918,2533905
1475,8516,0,1931,6585,1816315,2532978
1476,8662,0,2043,6619,1821158,2530516
1477,8650,0,1975,6675,1815634,2533837
1478,8522,0,1963,6559,1791800,2535471
1479,8516,0,2018,6498,1785386,2530447
1480,8580,0,1945,6635,1775829,2529110
1481,8685,0,2060,6625,1785752,2532226
1482,8692,0,1923,6769,1782367,2529669
1483,8583,0,1907,6676,1792601,2532140
1484,8665,0,1969,6696,1759503,2535092
1485,8500,0,1964,6536,1746078,2533119
1486,8558,0,1975,6583,1748463,2533373
1487,8572,0,1952,6620,1752199,2537477
1488,8677,0,1988,6689,1748887,2534619
1489,8584,0,1944,6640,1734738,2532926
1490,8690,0,1991,6699,1736917,2535491
1491,8681,0,1925,6756,1734545,2528507
1492,8655,0,1984,6671,1721852,2531144
1493,8615,0,1953,6662,1714822,2532989
1494,8669,0,1927,6742,1742931,2529046
1495,8810,0,2023,6787,1759537,2533147
1496,8530,0,1918,6612,1737261,2537030
1497,8720,0,1991,6729,1727709,2529199
1498,8545,0,2052,6493,1690832,2535751
1499,8498,0,1916,6582,1675752,2532530
1500,8585,0,1975,6610,1680137,2533006
1501,8926,0,2388,6538,1704056,2533253
1502,8641,0,2134,6507,1713374,2535248
1503,8835,0,2257,6578,1729084,2528549
1504,8910,0,2183,6727,1760158,2524719
1505,9084,0,2310,6774,1745516,2536327
1506,8843,0,2270,6573,1719052,2536556
1507,8773,0,2227,6546,1721003,2530365
1508,8875,0,2245,6630,1706630,2534354
1509,8837,0,2209,6628,1729818,2528269
1510,8862,0,2147,6715,1704013,2533036
1511,8773,0,2211,6562,1730082,2535267
1512,8941,0,2310,6631,1708357,2536825
1513,8796,0,2199,6597,1716140,2533462
1514,8824,0,2242,6582,1720065,2529067
1515,8790,0,2219,6571,1699279,2534806
1516,8967,0,2279,6688,1709558,2524362
1517,8732,0,2214,6518,1722206,2533767
1518,8845,0,2195,6650,1711283,2536613
1519,8892,0,2187,6705,1709698,2527296
1520,8971,0,2224,6747,1710190,2532889
1521,9052,0,2178,6874,1697495,2528997
1522,8881,0,2235,6646,1725048,2529949
1523,8976,0,2202,6774,1703661,2535162
1524,8825,0,2152,6673,1704971,2535976
1525,8905,0,2303,6602,1701117,2532571
1526,9080,0,2208,6872,1718003,2531042
1527,8814,0,2153,6661,1697858,2532968
1528,9021,0,2289,6732,1696746,2532740
1529,8858,0,2249,6609,1687228,2537021
1530,8835,0,2209,6626,1676799,2534817
1531,8833,0,2309,6524,1665304,2528682
1532,8897,0,2271,6626,1675420,2529679
1533,8875,0,2254,6621,1656051,2537846
1534,8773,0,2202,6571,1653242,2535232
1535,8910,0,2256,6654,1651731,2537377
1536,8879,0,2246,6633,1622705,2536990
1537,8806,0,2247,6559,1648835,2532992
1538,8642,0,2158,6484,1634261,2533956
1539,8652,0,2125,6527,1609408,2531695
1540,8881,0,2199,6682,1617953,2532489
1541,8867,0,2232,6635,1622681,2534703
1542,8788,0,2147,6641,1607187,2533476
1543,8712,0,2199,6513,1608526,2532728
1544,8795,0,2247,6548,1584551,2535302
1545,8916,0,2280,6636,1602244,2531200
1546,8816,0,2263,6553,1588456,2532241
1547,8848,0,2203,6645,1594692,2537999
1548,8850,0,2275,6575,1628362,2531377
1549,8881,0,2270,6611,1606483,2533059
1550,8810,0,2159,6651,1602051,2536040
1551,8814,0,2132,6682,1599151,2531668
1552,8916,0,2197,6719,1608088,2536307
1553,8963,0,2192,6771,1599982,2533758
1554,8825,0,2213,6612,1580829,2533847
1555,8706,0,2154,6552,1577420,2539548
1556,8973,0,2304,6669,1595551,2534411
1557,8997,0,2282,6715,1575562,2532762
1558,8515,0,2058,6457,1541747,2530797
1559,8954,0,2274,6680,1549737,2536060
1560,8887,0,2203,6684,1581392,2532161
1561,9024,0,2273,6751,1557029,2532914
1562,9067,0,2228,6839,1545764,2534390
1563,9070,0,2260,6810,1551905,2532813
1564,8908,0,2139,6769,1539248,2535955
1565,8966,0,2149,6817,1537357,2531690
1566,9183,0,2118,7065,1534509,2530243
1567,8904,0,2121,6783,1517557,2530146
1568,9126,0,2136,6990,1538192,2527714
1569,9230,0,2147,7083,1527826,2532546
1570,9220,0,2167,7053,1513290,2532228
1571,9135,0,2188,6947,1519593,2535396
1572,9085,0,2188,6897,1512078,2533107
1573,9176,0,2160,7016,1529265,2533871
1574,9156,0,2143,7013,1542889,2527780
1575,9018,0,2137,6881,1539382,2529457
1576,9175,0,2172,7003,1511713,2528996
1577,9139,0,2190,6949,1527733,2533611
1578,9253,0,2249,7004,1542101,2535674
1579,9021,0,2126,6895,1523501,2533758
1580,9125,0,2088,7037,1504141,2528666
1581,9094,0,2084,7010,1501353,2531905
1582,9141,0,2199,6942,1514326,2531684
1583,9167,0,2184,6983,1488696,2534689
1584,9137,0,2170,6967,1511731,2534623
1585,9076,0,2103,6973,1504427,2531475
1586,9060,0,2178,6882,1493537,2533410
1587,9048,0,2150,6898,1482055,2529912
1588,9157,0,2208,6949,1502604,2531677
1589,9224,0,2220,7004,1527591,2538021
1590,9082,0,2138,6944,1492002,2531270
1591,9167,0,2197,6970,1476817,2532209
1592,9008,0,2199,6809,1460989,2535135
1593,8970,0,2207,6763,1470955,2530836
1594,9164,0,2154,7010,1497192,2531784
1595,9055,0,2081,6974,1493762,2533514
1596,9316,0,2165,7151,1493618,2532780
1597,9095,0,2168,6927,1482156,2533451
1598,8967,0,2141,6826,1450824,2535141
1599,9181,0,2178,7003,1478187,2532866
1600,9159,0,2135,7024,1472676,2534120
1601,8989,0,2212,6777,1450041,2531963
1602,8990,0,2054,6936,1448636,2530265
1603,8914,0,2125,6789,1411080,2537373
1604,9074,0,2128,6946,1450678,2533466
1605,9173,0,2182,6991,1456556,2534971
1606,8936,0,2088,6848,1456840,2529930
1607,9020,0,2120,6900,1432951,2533194
1608,9006,0,2232,6774,1435530,2532115
1609,9034,0,2106,6928,1426541,2532123
1610,9103,0,2143,6960,1435917,2531183
1611,9060,0,2208,6852,1439979,2532882
1612,9094,0,2183,6911,1430145,2534311
1613,9030,0,2166,6864,1416522,2530254
1614,9012,0,2223,6789,1411221,2536018
1615,9137,0,2207,6930,1443637,2528058
1616,8963,0,2087,6876,1403659,2531718
1617,9136,0,2128,7008,1416100,2533445
1618,9085,0,2126,6959,1410930,2535122
1619,9136,0,2194,6942,1406308,2534216
1620,9053,0,2158,6895,1408908,2535174
1621,8881,0,2090,6791,1368274,2531893
1622,8819,0,2041,6778,1340439,2531411
1623,8854,0,1993,6861,1325993,2533556
1624,8832,0,2011,6821,1352199,2529199
1625,8822,0,1898,6924,1326420,2535628
1626,8729,0,1956,6773,1308534,2534063
1627,8954,0,2028,6926,1335353,2529607
1628,8853,0,1976,6877,1354854,2530266
1629,8984,0,2022,6962,1326726,2535719
1630,8803,0,1993,6810,1312011,2531428
1631,8848,0,1942,6906,1317550,2529078
1632,8841,0,1943,6898,1341017,2533704
1633,8835,0,1970,6865,1333354,2532260
1634,8753,0,1986,6767,1321054,2532480
1635,8778,0,1898,6880,1317926,2534528
1636,8891,0,1960,6931,1318447,2533997
1637,8835,0,1894,6941,1306640,2530670
1638,8847,0,1908,6939,1308640,2531207
1639,8739,0,2011,6728,1310443,2538047
1640,8711,0,1952,6759,1325443,2527754
1641,8847,0,1943,6904,1346626,2529638
1642,8885,0,1944,6941,1360985,2528613
1643,8831,0,1936,6895,1345351,2531663
1644,8793,0,1953,6840,1351054,2526415
1645,8852,0,1971,6881,1346671,2530922
1646,8750,0,1884,6866,1341180,2528175
1647,8960,0,1996,6964,1375692,2533345
1648,8993,0,1955,7038,1408174,2530288
1649,8757,0,1944,6813,1363346,2530623
1650,8884,0,1941,6943,1326165,2534294
1651,8874,0,1932,6942,1335499,2531592
1652,8907,0,1955,6952,1363257,2529206
1653,8918,0,2024,6894,1351331,2529923
1654,8976,0,1920,7056,1341302,2532123
1655,8927,0,1938,6989,1344660,2533328
1656,8726,0,1950,6776,1335526,2529847
1657,8970,0,1915,7055,1325579,2535378
1658,8746,0,1942,6804,1329732,2533655
1659,8991,0,1930,7061,1349240,2535341
1660,8900,0,1981,6919,1328886,2535046
1661,8813,0,1881,6932,1327059,2533553
1662,8898,0,1981,6917,1346061,2531149
1663,8889,0,1925,6964,1352188,2531499
1664,8806,0,1933,6873,1338286,2534724
1665,8852,0,2017,6835,1354637,2533037
1666,8769,0,1937,6832,1352396,2532681
1667,8877,0,1992,6885,1341817,2529076
1668,8912,0,1962,6950,1346194,2533779
1669,8887,0,1945,6942,1352900,2528645
1670,8973,0,1924,7049,1373014,2534420
1671,8879,0,1922,6957,1381278,2533168
1672,8868,0,1963,6905,1367724,2533982
1673,8995,0,1998,6997,1350342,2531674
1674,8934,0,2011,6923,1353884,2534864
1675,8848,0,1965,6883,1346738,2528776
1676,8807,0,1889,6918,1342285,2531287
1677,8916,0,2000,6916,1346555,2531546
1678,8870,0,1917,6953,1368768,2524773
1679,8863,0,2010,6853,1353597,2529165
1680,8782,0,1957,6825,1343244,2534561
1681,8551,0,1979,6572,1376212,2530515
1682,8471,0,2041,6430,1364293,2533492
1683,8524,0,1983,6541,1378433,2528830
1684,8636,0,2011,6625,1393509,2535513
1685,8534,0,1966,6568,1359240,2535763
1686,8524,0,1976,6548,1394804,2531848
1687,8564,0,1890,6674,1382237,2535561
1688,8413,0,1866,6547,1362820,2534107
1689,8567,0,1922,6645,1367676,2531116
1690,8545,0,1869,6676,1395619,2525422
1691,8558,0,1946,6612,1380351,2529910
1692,8497,0,1896,6601,1390950,2532492
1693,8399,0,1882,6517,1378494,2531775
1694,8545,0,1846,6699,1392048,2533376
1695,8512,0,1904,6608,1380316,2532709
1696,8569,0,1968,6601,1377921,2533459
1697,8435,0,1861,6574,1367255,2533530
1698,8494,0,1866,6628,1362118,2529869
1699,8544,0,1977,6567,1364101,2531810
1700,8490,0,1923,6567,1371992,2532539
1701,8557,0,1937,6620,1390651,2530987
1702,8546,0,1967,6579,1359650,2533491
1703,8428,0,1859,6569,1369776,2531645
1704,8703,0,1887,6816,1393794,2529312
1705,8626,0,1937,6689,1400849,2537044
1706,8503,0,1900,6603,1371089,2534615
1707,8455,0,1895,6560,1350531,2530912
1708,8475,0,1971,6504,1347133,2529872
1709,8453,0,1874,6579,1368147,2529454
1710,8491,0,1950,6541,1368242,2529230
1711,8677,0,1949,6728,1389334,2532187
1712,8534,0,1882,6652,1364726,2529257
1713,8533,0,1914,6619,1401650,2530565
1714,8557,0,1923,6634,1359480,2535158
1715,8694,0,1919,6775,1361971,2530746
1716,8582,0,1956,6626,1363578,2534446
1717,8512,0,1862,6650,1337738,2534008
1718,8544,0,1910,6634,1346429,2533460
1719,8438,0,1909,6529,1360616,2535294
1720,8455,0,1956,6499,1371620,2530387
1721,8537,0,1920,6617,1375640,2534409
1722,8535,0,1847,6688,1387350,2526411
1723,8509,0,1888,6621,1372552,2530870
1724,8441,0,1883,6558,1345529,2534793
1725,8462,0,2005,6457,1317094,2534970
1726,8608,0,1959,6649,1374778,2530531
1727,8583,0,1927,6656,1350956,2536059
1728,8567,0,1945,6622,1359249,2533998
1729,8671,0,1887,6784,1378131,2535634
1730,8419,0,1876,6543,1379350,2529332
1731,8519,0,1853,6666,1396363,2534686
1732,8457,0,1854,6603,1386824,2526288
1733,8662,0,1971,6691,1400401,2534339
1734,8585,0,1853,6732,1389123,2535165
1735,8377,0,1925,6452,1358237,2534873
1736,8654,0,1912,6742,1401725,2526414
1737,8543,0,1965,6578,1394294,2535563
1738,8363,0,1947,6416,1386711,2533773
1739,8562,0,1921,6641,1385918,2532426
1740,8452,0,1870,6582,1371826,2532161
1741,8480,0,1942,6538,1363884,2532724
1742,8450,0,1951,6499,1367537,2533858
1743,8578,0,2063,6515,1384198,2535403
1744,8624,0,1918,6706,1409874,2532920
1745,8518,0,1931,6587,1398875,2526367
1746,8567,0,1945,6622,1398136,2530897
1747,8567,0,1954,6613,1412783,2530216
1748,8593,0,1874,6719,1415782,2532595
1749,8536,0,1862,6674,1428039,2528589
1750,8531,0,1853,6678,1430912,2532044
1751,8542,0,1886,6656,1418965,2533165
1752,8711,0,1912,6799,1455260,2530555
1753,8441,0,1886,6555,1430982,2530012
1754,8366,0,1755,6611,1419975,2537440
1755,8518,0,1926,6592,1425658,2530472
1756,8548,0,1911,6637,1426834,2534329
1757,8486,0,1836,6650,1421308,2531378
1758,8540,0,1840,6700,1437230,2528165
1759,8605,0,1922,6683,1444202,2530511
1760,8658,0,1971,6687,1460926,2534965
1761,8456,0,1875,6581,1473235,2529251
1762,8652,0,1884,6768,1474748,2535569
1763,8299,0,1823,6476,1449471,2531615
1764,8294,0,1803,6491,1430263,2534153
1765,8321,0,1821,6500,1438043,2528559
1766,8511,0,1875,6636,1449904,2531842
1767,8490,0,1939,6551,1451263,2531007
1768,8599,0,1907,6692,1479419,2528282
1769,8488,0,1828,6660,1470094,2532086
1770,8447,0,1945,6502,1466649,2531471
1771,8304,0,1831,6473,1455948,2533697
1772,8440,0,1851,6589,1468038,2532773
1773,8564,0,1901,6663,1480460,2531180
1774,8684,0,1909,6775,1491093,2527880
1775,8617,0,1977,6640,1469261,2532035
1776,8471,0,1863,6608,1503728,2527049
1777,8442,0,1841,6601,1495409,2533587
1778,8547,0,1862,6685,1522864,2531823
1779,8363,0,1866,6497,1489979,2531141
1780,8548,0,1919,6629,1485963,2530835
1781,8490,0,1930,6560,1485095,2529654
1782,8417,0,1843,6574,1503138,2530498
1783,8402,0,1858,6544,1504472,2532848
1784,8601,0,1944,6657,1542666,2532862
1785,8545,0,1935,6610,1520893,2534448
1786,8376,0,1790,6586,1510296,2527591
1787,8408,0,1919,6489,1489541,2529721
1788,8467,0,1888,6579,1492654,2530118
1789,8489,0,1915,6574,1502553,2529481
1790,8537,0,1914,6623,1502913,2533006
1791,8594,0,1937,6657,1532207,2534006
1792,8401,0,1869,6532,1493142,2534251
1793,8350,0,1876,6474,1503790,2534055
1794,8392,0,1886,6506,1519662,2532152
1795,8474,0,1911,6563,1514102,2534329
1796,8420,0,1857,6563,1514757,2528740
1797,8516,0,1949,6567,1522393,2531721
1798,8466,0,1869,6597,1520168,2534821
1799,8584,0,1955,6629,1524946,2528091
